{
    "in":{
        "00": "-00",
        "01": "-01",
        "02": "-02",
        "03": "-03",
        "04": "-04",
        "05": "-05",
        "10": "-10",
        "11": "-11",
        "12": "-12",
        "13": "-13",
        "14": "-14",
        "15": "-15"
    }
}
